LEDGER_ID = ID
LEDGERCODE = Code
LEDGERNAME = Name
LEDGERNAMEGUJARATI = Gujarati
BILLINGADDRESS = Address
BILLINGSTATE = State
BILLINGSTATECODE = StateCode
SHIPPINGADDRESS = ShipAddress
SHIPPINGSTATE = ShipState
SHIPPINGSTATECODE = ShipSCode
STATE_ID = ID
STATECODE = StateCode
STATENAME = StateName
ITEMGROUP_ID = ID
ITEMGROUPCODE  = Code
ITEMGROUPNAME = Name
ITEM_ID = ID
ITEMCODE = Code
ITEMNAME = Name
ITEMNAMEGUJARATI = IGujarati
SALERATE = Sale Rate
CGSTPER = CGST%
SGSTPER = SGST%
IGSTPER = IGST%
SHORTNAME = Short
INVOICE_ID = ID
INVOICETYPE = Invoice Type
ENTRYDATE = Entry Date
ENTRYBY = Entry By
ENTRYIP = Entry IP
UPDATEDATE = Update Date
UPDATEBY = Update By
UPDATEIP = Update IP
REFNO1 = Ref No1
REFNO2 = Ref No2
REMARK = Remark
STATUS = Status
DEPARTMENTCODE = Code
DEPARTMENTNAME = Dept
DEPARTMENT_ID = ID
DESIGNATIONCODE = Code
DESIGNATIONNAME = Desig
DESIGNATION_ID = ID
EMPLOYEECODE = Emp Code
EMPLOYEENAME = Emp Name
EMPLOYEE_ID = ID
PROCESSCODE = Prc Code
PROCESSNAME = Prc Name
PROCESS_ID = ID
SHAPECODE = Shp Code
SHAPENAME = Shp Name
SHAPE_ID = ID
COLORCODE = Color Code
COLORNAME = Color Name
CLARITYCODE = Clarity Code
CLARITYNAME = Clarity Name
CLARITY_ID = ID
CUTCODE = Cut Code
CUTNAME = Cut Name
POLCODE = Polish Code
POLNAME = Polish Name
SYMCODE = Sym Code
SYMNAME = Sym Name
FLCODE = FL Code
FLNAME = FL Name
CHARNICODE = Chr Code
CHARNINAME = Chr Name
CHARNI_ID = ID
REJECTIONCODE = Rej Code
REJECTIONNAME = Rej Name
REJECTION_ID = ID
KAPAN_ID = Kapan ID
KAPANNAME = Kapan
KAPANCARAT = Kap. Carat
INVOICENAME = Invoice
LABOURRATE = Lab.Rate
LABOURTYPE = Lab.Type
LOTPCS = Lot Pcs
LOTCARAT = Lot Cts
BALANCEPCS = Bal Pcs
BALANCECARAT = Bal Cts
JANGEDDATE=JangedDate
TRANSDATE=Trans Date
ISSUEPCS=Issue Pcs
ISSUECARAT=Issue Cts
LEDGERGROUP=LedgerType
AUTOCONFIRM=AutoConf
PACKETTAG=Pkt
PACKETNO=PktNo
TAG=Tag
AMOUNT=Amt
SEQUENCENO=Seq
CURRENCYNAME=Currency
COUNTRYNAME=Country
PARTYCODE = Code
PARTYNAME = Name
PARTYTYPE = Type
LABCODE = Lab Code
LABNAME = Lab Name
SIZECODE = Size Code
SIZENAME = Size Name
LOCATIONCODE = Location Code
LOCATIONNAME = Location Name
NATTSCODE = Natts Code
NATTSNAME = Natts Name
MILKYCODE = Milky Code
MILKYNAME = Milky Name
EYECLEANCODE = Eyeclean Code
EYECLEANNAME = Eyeclean Name
BROWNCODE = Brown Code
BROWNNAME = Brown Name
LBLCCODE = LBLC Code
LBLCNAME = LBLC Name
LUSTERCODE = Luster Code
LUSTERNAME = Luster Name
GRAINCODE = Grain Code
GRAINNAME = Grain Name
BLACKINCCODE = BInc Code
BLACKINCNAME = BInc Name
OPENINCCODE = OInc Code
OPENINCNAME = OInc Name
WHITEINCCODE = WInc Code
WHITEINCNAME = WInc Name
NATURALCODE = Natural Code
NATURALNAME = Natural Name
HACODE = HA Code
HANAME = HA Name
PAVCODE = Pav Code
PAVNAME = Pav Name
COLORSHADECODE = Brown Code
COLORSHADENAME = Brown Name



